$$$ exec p1 : [filler_krioliin/src/krioliin.filler]
Plateau 24 40:
    0123456789012345678901234567890123456789
000 ........................................||||||||||
001 ........................................||||||||||
002 ........................................||||||||||
003 ...OO...................................||||||||||
004 ...OO...................................||||||||||
005 ...OOOO.................................||||||||||
006 ......OOOOOOO...........................||||||||||
007 ............OOO.........................||||||||||
008 .............OOOOOO.....................||||||||||
009 ................OO.OOOO.................||||||||||
010 .................O..O.O.................||||||||||
011 ......................OO................||||||||||
012 .......................OO.............XX||||||||||
013 .........................OOOOOOOOOOOOOOX||||||||||
014 ..........................O......X.....X||||||||||
015 .........................OO......XXXXXXX||||||||||
016 ..........................OOO....XXXXXXX||||||||||
017 ..........................OOO....XXXXX..||||||||||
018 ..........................O.OOO....XX.X.||||||||||
019 ........................OOO.OOO.XXXX.XX.||||||||||
020 .......................OOOO..O..XXX..XXX||||||||||
021 .......................OOO..X.X.XXXXXXXX||||||||||
022 .......................O.OXXXXXXXXXXXXXX||||||||||
023 ...........................XXXXXXXXXXX.X||||||||||
Piece 3 4:
..**
..*.
.***
