$$$ exec p1 : [filler_krioliin/src/krioliin.filler]
Plateau 24 40:
    0123456789012345678901234567890123456789
000 ........................................
001 ........................................
002 ........................................
003 ...OO...................................
004 ...OOO..................................
005 .....OOOOOOO............................
006 ......OO.OOO............................
007 ...........O............................
008 ...........OO...........................
009 ...........OO...........................
010 ...........OOOOO........................
011 ...............O........................
012 ...............OO.......................
013 ................OO....................X.
014 .................OO...............XXXXXX
015 ..................OOO................XXX
016 ..................OOO................XXX
017 ..................O...............XX..X.
018 ..................O...............XX.XX.
019 ..................OO..........XXXXXX.XXX
020 ..................O.OO.........XXXXXXXXX
021 ..................OOOO........XXXXXX.X..
022 ...................OO..........XXXXXXXXX
023 ...............................X.XXXXXXX
Piece 4 5:
.*...
.**..
**...
*....
Plateau 24 40:
    0123456789012345678901234567890123456789
000 ........................................
001 ........................................
002 ........................................
003 ...OO...................................
004 ...OO...................................
005 ...OOOO.................................
006 ......OOOOOOO...........................
007 ............OOO.........................
008 .............OOOOOO.....................
009 ................OO.OOOO.................
010 .................O..O.O.................
011 ......................OO................
012 .......................OO.............XX
013 .........................OOOOOOOOOOOOOOX
014 ..........................O......X.....X
015 .........................OO......XXXXXXX
016 ..........................OOO....XXXXXXX
017 ..........................OOO....XXXXX..
018 ..........................O.OOO....XX.X.
019 ........................OOO.OOO.XXXX.XX.
020 .......................OOOO..O..XXX..XXX
021 .......................OOO..X.X.XXXXXXXX
022 .......................O.OXXXXXXXXXXXXXX
023 ...........................XXXXXXXXXXX.X
Piece 3 4:
..**
..*.
.***
Plateau 24 40:
    0123456789012345678901234567890123456789
000 ........................................
001 ........................................
002 ........................................
003 ...OO...................................
004 ...OOO..................................
005 .....OOOOOOO............................
006 ......OO.OOO............................
007 ...........O............................
008 ...........OO...........................
009 ...........OO...........................
010 ...........OOOOO........................
011 ...............O........................
012 ...............OO.......................
013 ................OO....................X.
014 .................OO...............XXXXXX
015 ..................OOO................XXX
016 ..................OOO................XXX
017 ..................O...............XX..X.
018 ..................O...............XX.XX.
019 ..................OO..........XXXXXX.XXX
020 ..................O.OO.........XXXXXXXXX
021 ..................OOO........XXXXXX.X..
022 ...................OO..........XXXXXXXXX
023 ...............................X.XXXXXXX
