$$$ exec p1 : [filler_krioliin/src/krioliin.filler]
Plateau 24 40:
    0123456789012345678901234567890123456789
000 ........................................
001 ........................................
002 ........................................
003 ...OOO..................................
004 ...OOOOOOOOO............................
005 ........O.OOOOOOO.......................
006 ...........O.O...OOOOOOO................
007 .......................O................
008 .......................O................
009 .......................OOO..............
010 ........................OOO.............
011 .........................OOOO.......OOOO
012 ..........................OOOOOOOOOOOOXX
013 ..........................O...OOOO..O..X
014 .................OOOOOOOOOO.........XXXX
015 ..........................OO.....X.XXXXX
016 ........................OOO.......XXXXXX
017 .........................O..........XXX.
018 ......................O.OOO.........XXX.
019 ......................OOOO.....XXXXXXXX.
020 ......................OO......XXXXXXXX.X
021 ........................X.X.XXXXXXX.XX.X
022 ......................XXXXXXXXXXXXXXXXXX
023 ............................X.X.XXXXXXXX
Piece 4 5:
..*..
.***.
...*.
...*.
