$$$ exec p1 : [filler_krioliin/src/krioliin.filler]
Plateau 24 40:
    0123456789012345678901234567890123456789
000 ........................................
001 ....O...................................
002 ...OOO..................................
003 ...OOO..................................
004 .....OOOO...............................
005 ......O.O...............................
006 ........OOO.............................
007 ..........OOOOO.........................
008 ..............OOOOO.....................
009 ..................OO....................
010 ..................OOOOO.................
011 ...................OO.O.................
012 ......................O.................
013 .......................O................
014 .......................O................
015 ........................OO.......XXX....
016 ........................OOO......X......
017 .........................OOO.....X..X...
018 ..........................OO.....X.XXXX.
019 ...........................O....XXXXX...
020 ...............................XXX..X...
021 .............................X..X.XXX.X.
022 .............................XXXXXXXX.X.
023 .............................XXX.XXXXXXX
Piece 1 3:
***
Plateau 24 40:
    0123456789012345678901234567890123456789
000 ........................................
001 ........................................
002 ........................................
003 ...O....................................
004 ........................................
005 ........................................
006 ........................................
007 ........................................
008 ........................................
009 ........................................
010 ........................................
011 ........................................
012 ........................................
013 ........................................
014 ........................................
015 ........................................
016 ........................................
017 ........................................
018 ........................................
019 ................................xxxx....
020 ........................................
021 ........................................
022 ........................................
023 ........................................
Piece 4 5:
...**
.....
.....
.....
